1.SACERDOTE: Actúa como un sacerdote (Mantén el crucifijo en la mano).
2.LÍDER: Eres el líder durante toda la partida.
3.CAMARÓGRAFO: Necesitas una cámara y hacer fotos a todo lo que pase.
4.ACOSADOR: Acosa a un compañero e imítale hasta que muera.
5.AMO DE CASA: No puedes salir de la casa hasta que alguien muera.
6.CAMIONERO: Quédate en el camión toda la partida.
7.SOLITARIO: Tienes que estar solo durante toda la partida.
8.CIEGO: No tienes permitido tener fuentes de luz ni encender luces.
9.MUDO: Silénciate y no hables nunca (si éste rol entra en conflicto con otro, se preserva el primero que haya salido. Situación posible con el rol 42).
10.ENANO: Tienes que ir agachado la partida entera.
11.EL CÓMICO: Intenta ser divertido.
12.IRRITANTE: No pares de hablar incluso si el fantasma entra en modo caza.
13.CONSERJE: Tú vas primero siempre y cierra todas las puertas cuando salgas.
14.AUSENTE: Quédate ausente 2 minutos (elige una habitación).
15.NIÑO: Tienes que preguntar todo el tiempo si quieren que hagas algo.
16.CAZA FANTASMAS: Tienes que ver al fantasma por lo menos una vez.
17.BROMISTA: Tú siempre debes estar gastando bromas.
18.SABOTEADOR: Intenta fastidiarlo todo, arruina la partida.
19.USAIN BOLT: No puedes esconderte, corre.
20.VAGO: No puedes usar equipamiento (linterna sí permitida).
21.DROGADICTO: Sin que nadie se de cuenta, pímplate todas las pastillas , fúmate todos los porros (varillas de incienso) y esnifate toda la coca (sal).
22.KENNY: Tienes que morir en la partida.
23.LESIONADO: No puedes esprintar.
24.CLEPTÓMANO: Roba todos los objetos que puedas de la casa.
25.PERRITO FALDERO: Elije a un jugador y síguelo durante toda la partida.
26.CANTANTE: Cuando el fantasma esté en modo caza, tienes que cantar.
27.ABUELITO: Cada 10 pasos tienes que pararte 2 segundos.
28.EN SILLA DE RUEDAS: No puedes subir ni bajar escaleras.
29.EL MUÑONES: No puedes abrir ni cerrar puertas.
30.EL MEÓN: Cada medio minuto tienes que ir al baño y encerrarte 10 segundos.
31.ASUSTADIZO: A cada sonido, interacción u otro evento generado por el fantasma tienes que esconderte en un armario.
32.FANTASMA: Intenta asustar a tus compañeros.
33.ANIMADOR: Tienes que animar a tus compañeros y congratular cada cosa que hagan.
34.EL CHULO: Plántale cara al fantasma.
35.MOONWALKER: Tienes que caminar todo el rato de espaldas.
36.EL PESAO: Tienes que hablarle todo el rato al fantasma dirigiéndote a él por su nombre.
37.CSI: Solo puedes alumbrarte con la linterna ultravioleta.
38.QUEJICA: Tienes que quejarte de todo, sobretodo cuando el fantasma está en modo caza.
39.CURA: Tienes que celebrar un funeral cuando un jugador muera.
40.EL DE LA EDAD MEDIA: Solo puedes utilizar velas para iluminarte.
41.AHORRADOR DE LUZ: Tienes que mantener todas las luces de la casa apagadas. (No sirve quitar los plomos).
42.TRIPOLAR: Genera 2 roles más (si vuelve a salir el 42, se añaden otros 2 roles a los que ya llevas).
43.DETECTIVE: Averigua los roles de tus compañeros.
44.NICTOFÓBICO: Enciende las luces de todas las habitaciones en las que entres.
45.GORDO RAMSAY: No puedes salir de la cocina y, cada vez que pase un compañero, tienes que insultarle.
46.COMO FUNCIONA ESTO?: No puedes usar la radio